1111111111111111111111111
1111100000000000000000001
1011100000111100000000001
1000000000000000000000001
1000011110000000000000001
1000000000000000000000001
1000000000000111000001111
1000000000000000000111111
1111111111111111111111111