24
8
1111111111111111111111111
1111130000000000000000001
1011100000111100000020001
1000020000000000000000001
1000011110000000000000001
1000000000000000000200001
1000000000000111000001111
1002000000000000004111111
1111111111111111111111111